XXXXXXXXXXXXXXXXXXXXXXXXXXXXXX
X|000000|00000X000000|000000|X
X0000000000000|00000000000000X
X0000XXX000000X000000XXX00000X
X00|00|X00|000X000|00X|000|00X
X00|00|X000000|000000X|000|00X
X0000XXX00|000X000|00XXX00000X
X00000000|0000X00000|00000000X
X|000000|X0000X00000X|000000|X
XXX0|0X00X|000X0000|X00X0|0XXX  
00|000X000000|X|0000000X000|00
XXX0|0X0000000X00000000X0|0XXX 
X00000X|000000X0000000|X00000X
X00000XXX00000X000000XXX00000X
X0000000000X00|0000X000000000X
X0000000000X00|0000X000000000X
XXXXXXXXXXXXXXXXXXXXXXXXXXXXXX