XXXXXXXXXXXXXXXXXXXXXXXXXXXXXX
X00000000|0000000000|0000000|X
X|000|000|XXXX0XXXXX|000|000|X
X0000|000||000|0000||000|000|X
X0XXX0XXXX|000|0000|XXXX0XXX0X
X|000|000||0000|0000|000|000|X
X|0000000|XXXX0XXXXX|0000000|X
X|000|000|0000|00000|000|000|X
X XXX0XXXX|000|0000|XXXX0XXX X
 |000|000||000|0000||000|000| 
X|000|000|XXXXXXXXXX|000|000|X
X|000|000||000|0000||000|000|X
X XXX0XXXX0000|00000XXXX0XXX0X
 |000|000||000|0000||000|000| 
X|000|000|XXXX0XXXXX|000|000|X
X|000|000||000|0000||000|000|X
X0XXX0XXXX0000000000XXXX0XXX0X
X0000|0000|000|0000|0000|0000X
XXXXXXXXXXXXXXXXXXXXXXXXXXXXXX